_[]________________________________
|        |    #    |######   |    |
|        |    #    |######   |    |
|____##__|    |    |#|__|    |    |
|   |    |    |    |#|  |____|    |
|   #    |    |    |#|#####  |    |
|   |    |    |    |#|##|    |    |
|   |    #    |    #####|____|    |
| # | # ## # #|# # ############# #|
|___|_________|___________________|